LEVEL_IMAGE Small.png
LEVEL_WIDTH 10
LEVEL_HEIGHT 10
SPAWN_X 0
SPAWN_Y 0

LEVELSTART
30 46 44 32 45 10 46 36 9 28 
8 14 43 43 22 5 8 39 13 38 
3 36 47 16 28 39 40 47 8 34 
45 35 2 44 20 20 32 16 33 9 
8 31 21 34 1 17 19 34 44 18 
28 16 17 17 8 16 26 46 40 1 
2 3 45 10 23 20 46 44 6 16 
21 18 11 32 31 49 5 37 35 2 
3 39 33 8 38 26 12 21 46 28 
2 42 19 29 6 22 23 46 44 37 
LEVELEND

NPCSSTART
NPCSEND
