A0A1A2A3A4A5A6A7A8A9E8E8E8E8E8
B0B1B2B3B4B5B6B7B8B9E8E8E8E8E8
C0C1C2C3C4C5C6C7C8C9E8E8E8E8E8
D0D1D2D3D4D5D6D7D8D9E8E8E8E8E8
E0E1E2E3E4E5E6E7E8E9E8E8E8E8E8
E8E8E8E8E8E8E8E8E8E8E8E8E8E8E8
E8E8E8E8E8E8E8E8E8E8E8E8E8E8E8
E8E8E8E8E8E8E8E8E8E8E8E8E8E8E8
E8E8E8E8E8E8E8E8E8E8E8E8E8E8E8
E8E8E8E8E8E8E8E8E8E8E8E8E8E8E8
A0A1A2A3A4A5A6A7A8A9E8E8E8E8E8